#################################
#S#       #       #         #   #
# # ##### # # ### # ####### ### #
#   #   #   # #     #     #     #
# ##### ##### ####### # # ##### #
#     #     #   #     # # #   # #
##### ##### ### # ##### # ### # #
#     #       # #   # # #     # #
# ##### # ##### ### # # ##### # #
# #     # #   # #   # #   #   # #
# # # ##### # # # ### ### ### # #
# # #     # #   #     # #   # # #
# ####### # ### ##### # ### ### #
#     #   #   #     #     #     #
##### # # ### ########### #######
#       #   #                  F#
#################################