#################################################
#S          #       #       # #         #     # #
### ####### ### # # ##### # # # ### ### # # # # #
#   #     #   # # #       #   #   # #   # # #   #
# ### # ##### # # ########### # ### # ##### ### #
#   # #   #   # #   #   #     # #   #       #   #
# # # ### # ####### # ### ##### # ########### ###
# # # # #   #     # #     #     # #       # # # #
### # # ##### ### # ##### # ##### # ##### # # # #
#   # #         # #     # #     #   #     #   # #
# ### ######### # ### # ####### ##### ##### ### #
# #     #   #   #   # #             # #   #     #
# ##### # # # ##### ####### ######### # ####### #
#     # # # #     #   #   #   #     # #         #
# ### # # # ##### ### # # ### # ### # # #########
# # # #   #     # # # # # #   # # #   # #       #
# # # ######### # # # # # ##### # ##### # # #####
# # #   #   #     #     #   #   #     #   # #   #
# # ### # # ### ########### # ### ### ##### ### #
#     #   #   # #       #   # # # # #     #   # #
##### ####### ### ##### # ### # # # ### ### ### #
#     #       #   # #   #     #       #     #   #
####### ### ### ### # ######### ############# ###
#     #   # #   #   # # #       #           #   #
# ### ### ### ##### # # # ####### ######### ### #
#   #     #   #   # # # #   #   # #       # #   #
# # ####### ### # # # # ### ### # # # ##### # ###
# #       # #   #   # #         # # #   #   # # #
######### # # # ##### # ##### ### ##### # # # # #
#         #   # #     # #   # #   #     # # # # #
# ####### ##### # ##### # # ### ### ### # # # # #
# #   #   #     #   #   # # #   #   #   # # # # #
# ### # ### ####### # ### # # ### ####### ### # #
#   #   # #   #     # #   #   #         #   #   #
### # ### ### # # ##### ####### ####### ### ### #
#   #     #   # # #     #     # #   #     #     #
# # ####### ### ### ##### ### # # # # ###########
# # #   #   # # #   #     #   # # # #   #       #
# ### # # ### # # ####### # ### ### ### # ### ###
# #   # # #   #   #     # #   #     # #   # #   #
# # ### # ### ##### ### ### # ##### # ##### ### #
#   #   #       # #   #   # #     # #       #   #
# ### ######### # # # ### # ### ### # ### ### # #
#   # #   #     # # # #   # # # #   #   # #   # #
### # # # # ##### # # ### # # # # ##### ### ### #
# # # # # # #   #   #   # #   #         #   # # #
# # # # # # # # ####### # ############### ### # #
#   #   #     #         #                 #F    #
#################################################